0000011111100000
0000111111110000
0001111111111000
0011111111111100
0111111111111110
1111111111111111
1111111001111111
1111110000111111
1111110000111111
1111111001111111
1111111111111111
0111111111111110
0111111111111110
0011111111111100
0001111111111000
0000011111100000
